type octile
height 20
width 10
map
..........
..........
..........
..........
..........
..........
..........
..........
..........
..........
..........
..........
..........
..........
..........
..........
..@@@@@@@@
..@@@@@@@@
..........
..........
